11111111111111111111111111111111111111111111111111111
100011111111000100011111111000100011111111000111111101
10x010001000100010001000100010001000100000001000100011
1000000010001000100000001000100010001000000010y0100011
10y000001000000010000000100000001000100010001000100011
100000001000000010001000100000001000000010001000100011
1022010001000100010001000100010001000000010001000000011
100010001000102010001000100010001000000010000000100011
100000000000102010001000100010000000100010000000000011
100000000000100000001000000010000000100010000y00002011
1000100010001000000010y000010001000100010001000100011
100010001000100010001000100010001000100010001000100011
100010001000100010001000100010001000100010001000100011
100010001000100010001000100010001000100010001000100011
100010001000100010001000100010001000100010001000100011
100010001000100010001000100010001000100010001000100011
100010001000100010001000100010001000100010001000100011
100010001000100010001000100010001000100010001000100011
100010001000100010001000100010001000100010001000100011
100010001000100010001000100010001000100010001000100011
100010001000100010001000100010001000100010000000100011
100010001000100010001000100010001000100010000000100011
100010001000100010001000100010001000100010001000100011
100010001000100010001000100010001111111111111111111111
1111111111111111111111111111111111111111111111111111111
